The=sija
There=araiia
Then=kombula
They=rann
Their=vakugo
They’re=suras
There’s=sicia
Theirs=graπe 
Thought=ßwesche
To=yuka
Go=eiππen 
Store=ßuπsach
Home=ßuπrase
Work=ßuπur
A=akr
How=rasa
Who=bahaiir
What=isaga
When=ßata
Where=zoji
These=sijas
Are=arπos
You=dubá
Doing=ßoçi
Hello=nani 
I=salfas
Am=amore
Is=iraa
Would=jo
Could=feti
Should=ropasi
Have=juko
Name=alfas
My=salfas posetos
Your=yukka
Going=eiπn 
Good=ßuaga
Day=date
Night=πuyaat
Sounds=roi
Nice=niko
Awesome=niko
Song=soπga
Music=mazki
Comedy=comie
Us=rghaan
It=sie
Very=vial
Not a lot=shebben pak sheßei 
Funny=funa
Not funny=naare funa 
Not=naar
Or=ort
For=far
That=sao